9 8
0 0 3 3 3 3 3 0
3 3 3 0 0 0 3 0
3 2 4 1 0 0 3 0
3 3 3 0 1 2 3 0
3 2 3 3 1 0 3 0
3 0 3 0 2 0 3 3
3 1 0 5 1 1 2 3
3 0 0 0 2 0 0 3
3 3 3 3 3 3 3 3
0
